1111111111111
1C000000000C1
1000011011101
1P0011E001001
1111111111111