111111111111111111111111111111111111111111111111
1P0000000000000000000000000000000000000000000E01
100000C00000000000C000000000000000C0000000000001
100000000000000000000000000000000000000000000001
100000000C0000000000000000000C000000000000000001
100000000000000000000000000000000000000000000001
100000000000C00000000000000000000000000C00000001
100000000000000000000000000000000000000000000001
100000C00000000000000000000000000000000000000001
100000000000000000000000000000000000000000000001
1000000000000000000000000000000000000000C0000001
111111111111111111111111111111111111111111111111