1111111111111111
1111111111E0C0P1
1111111111111111
1111111111111111