1111111111111
1001000E000C1
1000000000001
1P0000E000011
1111111111111