1111111111111111
1111111000E0C0P1
111100C000000011
1111111111111111